--------------------
--------------------
--------------------
--------###---------
--------#.#---------
--------#-####------
------###$-$.#------
------#.-$@###------
------####$#--------
---------#.#--------
---------###--------
--------------------
--------------------
--------------------
--------------------