--------------------
--------------------
--------------------
------#####---------
------#---#---------
------#-$@#-###-----
------#-$$#-#.#-----
------###-###.#-----
-------##----.#-----
-------#---#--#-----
-------#---####-----
-------#####--------
--------------------
--------------------
--------------------