--------------------
--------------------
--------------------
--------------------
-------####---------
-------#-.#---------
-------#--###-------
-------#*@--#-------
-------#--$-#-------
-------#--###-------
-------####---------
--------------------
--------------------
--------------------
--------------------